1 1 1 1 1 1 1 1 1 1 1 0 0 1 1 1 1 1 1 1 1 1 1 1 1 1 1 1

1 1 1 1 1 1 1 1 1 1 1 9 9 1 1 1 1 1 1 1 1 1 1 1 1 1 1 1

1 1 1 1 1 1 1 1 1 1 1 0 0 1 1 1 1 1 1 1 1 1 1 1 1 1 1 1

0 0 0 0 0 0 0 2 0 0 0 0 0 0 0 0 0 0 0 1 1 1 1 1 1 1 1 1

0 0 0 0 0 0 0 2 0 0 0 0 0 0 0 0 0 0 0 1 1 1 1 1 1 1 1 1

1 1 1 1 1 1 1 1 1 4 4 4 4 0 0 0 0 4 4 4 1 1 1 1 1 1 1 1

1 1 1 1 1 1 1 1 1 4 4 4 4 0 1 1 1 4 4 4 1 1 1 1 1 1 1 1

1 1 1 1 1 1 1 1 1 4 4 4 4 0 4 4 4 4 4 0 1 1 1 1 1 1 1 1

1 1 1 1 1 1 1 1 1 4 4 4 4 0 4 4 4 4 4 0 1 1 1 1 1 1 1 1

1 1 1 1 1 1 1 1 1 4 0 0 0 0 0 0 4 4 4 0 1 1 1 1 1 1 1 1

1 1 1 1 1 1 1 1 1 4 0 1 1 0 4 4 4 4 0 1 1 1 1 1 1 1 1 1

1 1 1 1 1 1 1 1 1 4 0 1 1 0 4 4 4 4 0 1 1 1 1 1 1 1 1 1

1 1 1 1 1 1 1 1 1 4 0 1 1 0 0 0 0 0 0 3 1 1 1 1 1 1 1 1

1 1 1 1 1 1 1 1 1 4 0 1 1 1 1 1 1 1 1 1 1 1 1 1 1 1 1 1

1 1 1 1 1 1 1 1 1 0 0 0 0 0 0 4 4 4 4 0 1 1 1 1 1 1 1 1

1 1 1 1 1 1 1 1 1 4 4 4 4 4 0 4 4 4 4 1 1 1 1 1 1 1 1 1

1 1 1 1 1 1 1 1 1 4 4 4 4 4 0 4 4 4 4 0 1 1 1 1 1 1 1 1

1 1 1 1 1 1 1 1 1 4 0 4 4 4 0 4 4 4 4 4 1 1 1 1 1 1 1 1

1 1 1 1 1 1 1 1 1 4 0 4 4 4 0 4 0 0 0 0 1 1 1 1 1 1 1 1

1 1 1 1 1 1 1 1 1 4 0 0 0 0 0 0 0 0 0 0 1 1 1 1 1 1 1 1

1 1 1 1 1 1 1 1 1 4 0 1 1 1 4 4 4 4 4 4 1 1 1 1 1 1 1 1

1 1 1 1 1 1 1 1 1 4 0 1 1 1 1 1 1 1 1 1 1 1 1 1 1 1 1 1

1 1 1 1 1 1 1 1 1 4 0 0 0 4 4 4 4 4 0 0 1 1 1 1 1 1 1 1

1 1 1 1 1 1 1 1 1 4 4 4 4 4 4 4 4 4 0 0 1 1 1 1 1 1 1 1

1 1 1 1 1 1 1 1 1 0 0 0 4 4 4 4 4 4 0 0 1 1 1 1 1 1 1 1

1 1 1 1 1 1 1 1 1 0 0 0 4 4 4 4 4 4 4 4 1 1 1 1 1 1 1 1

1 4 4 4 4 4 4 4 4 4 4 4 4 4 4 4 4 4 4 4 1 1 1 1 1 1 1 1

1 4 4 4 4 4 4 4 4 4 4 4 4 4 4 4 4 4 4 4 1 1 1 1 1 1 1 1

1 4 4 4 4 0 4 4 4 4 4 4 4 0 0 0 0 0 0 4 1 1 1 1 1 1 1 1

1 4 4 4 4 0 4 4 4 4 4 4 4 0 4 4 4 4 4 4 1 1 1 1 1 1 1 1

1 4 4 4 4 0 0 0 0 0 0 0 0 0 4 0 0 0 0 0 1 1 1 1 1 1 1 1

1 4 4 4 4 0 1 4 4 0 1 1 1 0 4 0 0 0 0 0 1 1 1 1 1 1 1 1

1 0 0 0 0 0 1 4 4 0 0 0 0 0 0 0 0 0 0 0 1 1 1 1 1 1 1 1

3 0 0 0 0 0 1 4 4 0 4 4 4 4 4 0 0 0 0 0 1 1 1 1 1 1 1 1

1 0 0 0 0 0 1 4 4 0 4 4 4 4 4 0 0 0 0 0 1 1 1 1 1 1 1 1

1 1 1 1 1 1 1 4 4 0 4 4 4 4 4 0 0 0 0 0 1 1 1 1 1 1 1 1

1 1 1 1 1 1 1 1 1 1 1 4 4 4 4 0 0 0 0 0 1 1 1 1 1 1 1 1

1 1 1 1 1 1 1 1 1 1 1 4 4 4 4 0 0 0 0 0 1 1 1 1 1 1 1 1

1 1 1 1 1 1 1 1 1 1 1 6 6 6 6 6 6 6 6 6 1 1 1 1 1 1 1 1

1 1 1 1 1 1 1 1 1 1 1 6 6 6 6 6 6 6 6 6 1 1 1 1 1 1 1 1

1 1 1 1 1 1 1 1 1 1 1 6 6 6 6 6 6 6 6 6 1 1 1 1 1 1 1 1

1 1 1 1 1 1 1 1 1 1 1 6 6 6 6 6 6 6 6 6 1 1 1 1 1 1 1 1

1 1 1 1 1 1 1 1 1 1 1 6 6 6 6 6 6 6 6 6 4 0 0 0 0 0 0 0

1 1 1 1 1 1 1 1 1 1 1 4 0 0 0 0 4 4 4 4 4 0 0 0 0 0 0 0

1 1 1 1 1 1 1 1 1 1 1 4 0 0 0 0 4 4 4 4 4 0 0 0 0 0 0 0

1 1 1 1 1 1 1 1 1 1 1 4 4 4 4 4 4 4 4 4 4 0 0 0 0 0 0 0
